R 100 100
NO
SO
WE
EA
F
C
S

11111111
100000001
100010N01
100000001
111111111
