R 1000 500
SO ./wall_one.xpm
NO ./wall_one.xpm
WE ./wall_four.xpm
EA ./wall_three.xpm
S ./barrel.xpm
F 120,120,55
C 104,155,160

111111
102001
100001
100S01
111111
