111111111
100000001
100010001
100000001
111100001
