R 100 100
NO
SO
WE
EA
F
C
S

11111111111
10000000001
10001110N01
10001 10011
10001 10011
11111111111
