R 500 500
NO
SO
WE
EA
F
C
S

11111111111111111
10000000000000001
10100000001110N01
10000000001010001
10000000001110001
10000000000000001
10000000000000001
10000000000000001
10000000000000001
11111111111111111
