R 100 100
NO
SO
WE
EA
F
C
S

11111111N
100000001
100010001
100000001
111111111
