R 500 500
NO
SO
WE
EA
F
C
S

11111111111
10000000001
10101110N01
10001 10001
10001 10001
11111111111
