S 100 100

N /ouioui
SO
WE
EA
S
F
C

111111111
100000001
100010001
100000001
111111111
