R 1000 600

NO ./wall_one.xpm

SO ./wall_two.xpm

EA ./wall_three.xpm

WE ./wall_four.xpm

S ./barrel.xpm

F 120,120,55

C 104,155,160

1111111111111111111111111111
1002000100000000000000200001
1000000100000000000000000001
100N000111111000200000000001
10200201    1000000000000001
1000000111111000000000000001
1000000000000000000000000001
1000000000111111111111111111
10000001111
10000001
11111111


F 120,120,55
