R 1337 600

NO ./wall_one.xpm

SO ./wall_two.xpm
WE ./wall_four.xpm
EA ./wall_three.xpm
S ./barrel.xpm
F 120,120,55
C 104,155,160







11111111
10000001
10000001
10000001
10000001
10000001
1001111111111111
100000000000000111111111111111111
10020000000000000000000000000000111111111111111111111111111111111111111111111111111111111
10000000000000000000000000000000000000000000002000000000000000000000000000000000000000001
10000000000000000000000000000020000000000000000001111111111111111111111111111111111111111
10020000000200011111111111111111111111111111111111
1000000000000001
1111100011111111
    10001
    10001
    1000111111111111111111111111111111111111111111111111111111111111111111111111111111111111111111111111111111111111111111111111111111111111111111111
    1000000000000000000000000000000000000000000000000000000000000000000000000000000000000000000000000000000000000000000000000000000000000000000000001
11111001111111111111111111111111111111111111111111111111111111111111111111111111111111111111111111111111111111111111111111111111111111111111111111111
10000001
10000001
10000201
10000201
10000001
1001111111111111
100000000000000111111111111111111
100000000000000000000000000000001
100000000000000000000000000000001
100200000000000111111111111111111
1000000000000001
1111100011111111
    10001
    10001
    10001
    10001
1111100011111111
100000000000000111111111111111111
100000000N0000000000000000000000111111111111111111111111111111111111111111111111111111111
10000000000000000000000000000000000000000000000002000000000000000000000002000000000000001
10000000000000000000000000000000000000000000000001111111111111111111111111111111111111111
10000020000000011111111111111111111111111111111111
1000000000000001
1111100011111111
    10001
    10001
    10201
    10001
111110011
10000001
10000001
12000001
10000001
11111111
