R 100 100

NO ./textures/brick.xpm
SO ./textures/wood.xpm
EA ./textures/stone.xpm
WE ./textures/grass.xpm

C 144, 255, 0
F 155, 0, 156

11111111
10000001
10000001
10000001
100002011
110000001
 1S01111111111111
1100000000000000111111111111111111
100000202002000000000000000000001
100000202002000000000000111111111
100000202002000000000001111111111
100200202002000111111111111111111
1000000000000001
1111111111111111

