R 800 600
NO ./textures/brick.xpm
SO ./textures/wood.xpm
WE ./textures/grass.xpm
EA ./textures/stone.xpm
S ./textures/metal.xpm

1111111111111111
1111100011111111
100000000000000111111111111111111
10000000000000011111111111111111111111111111111111111111111111111111111
11111000111111111
    10001
    10001
    10001
    10001
111110011
10000001
10000001
10000001
10000001
10000001
1001111111111111
100000000000000111111111111111111
100000000000000000000000000000001
100000000000000000000000000000001
100000000000000111111111111111111
1000000000000001
1111100011111111
    10N01
    10001
    10001
    10001
    11111
