R 100000 600
NO ./wall_one.xpm
SO ./wall_two.xpm
EA ./wall_three.xpm
WE ./wall_four.xpm
S ./barrel.xpm
F 120,120,55
C 104,155,160

11111111
10020001
10000001
100N0001
10200201
10000001
11111111
