R 800 600
SO ./textures/wood.xpm
NO ./textures/brick.xpm
aaa
C 255,   255, 255

11111111111111111111111111111
10000000000000000000000000001
10000000000000000000000000001
10000000000000000000000000001
10000000100000000000000000001
10000000000000000000000000001
10000000000000000000020000001
100000000N0000000000000000001
10000000000000000000000000001
10000000000000000000000000001
10000000000000000000000000001
10000000000000000000000000001
10000000000000000000000000001
10000000000000000000000000001
10000000000000000000000000001
10000000000000000000000000001
11111111111111111111111111111
