R 800 600
NO ./textures/brick.xpm

C 255,   255, 255

111111111111111111111111111111
 10000100000100000001000000001
 10000000000000000000000000001
 10000100000100000001000000001
111011110111111110111101111111
10000010000010000000100000001
10000000000000000000120000001
100000100N0010000000100000001
10000010000010000000100000001
11101111011111111011110111111
10000010000010000000100000001
10000010000010000000100000001
10000010000010000000100000001
11101111011111111011110111111
10000010000000000000100000001
10000000000010000000000000001
11111111111111111111111111111
