R 800 600
NO ./textures/brick.xpm
SO ./textures/wood.xpm
WE ./textures/grass.xpm
EA ./textures/stone.xpm
S ./textures/metal.xpm


11111111
10000001
10000001
10000001
10000201
10000001
1S01111111111111
100000000000000111111111111111111
100000202002000000000000000000001
100000202002000000000000111111111
100000202002000000000001111111111
100200202002000111111111111111111
1000000000000001
1111111111111111

